4
-,-,-,B,-,-,-,T,-,-,-,-,-
-,B,-,-,-,-,-,-,-,,-,-,-
-,B,-,B,-,-,-,-,-,-,-,-,-
-,-,-,B,H,-,-,T,-,-,-,T,-
-,-,V,-,-,-,-,-,-,-,-,-,-
-,-,-,-,T,-,H,-,-,T,-,T,-
-,-,-,-,-,-,-,B,-,T,-,-,-
-,V,-,T,-,-,-,B,-,-,-,-,V
-,-,-,-,-,-,-,-,-,-,D,-,-
-,-,-,-,-,B,-,-,-,-,-,T,-
-,-,-,-,-,B,B,T,-,-,-,T,-